Mandala is a Brazilian telenovela produced and broadcast by TV Globo. It premiered on 12 October 1987 and ended on 14 May 1988, with a total of 185 episodes. It's the thirty eighth "novela das oito" to be aired on the timeslot. It is created by Dias Gomes and directed by Ricardo Waddington.


== Cast ==
Vera Fischer - Jocasta Silveira
Nuno Leal Maia - Tony Carrado
Lúcia Veríssimo - Letícia
Carlos Augusto Strazzer - Argemiro
Felipe Camargo - Édipo Junqueira
Gianfrancesco Guarnieri - Túlio Silveira
Célia Helena - Ceres Silveira
Gracindo Júnior - Creonte Silveira
Raul Cortez - Pedro Bergman
Oswaldo Loureiro - Américo Junqueira
Ângela Leal - Mercedes Junqueira
Imara Reis - Vera
Osmar Prado - Gerson Silveira
Bia Seidl - Mariana
Paulo Gracindo - Vovô Pepê (Petronílio Silveira)
Yara Côrtes - D. Conchita
Ilka Soares - Lena
Milton Gonçalves - Apolinário Santana
Aída Leiner - Eurídice Barbosa Santana
Grande Otelo - Jonas Caetano Barbosa
Ruth de Souza - Zezé (Maria José Barbosa)
Aracy Cardoso - Flora
Betina Viany - Ondina (Madame Lorrain)
Jayme Periard - Miguel
Jandir Ferrari - Toninho Carrado
Betty Erthal - Dalva
Lupe Gigliotti - Dona Severina
Fafy Siqueira - Jupira
Carlos Kroeber - Dr. Henrique...