Wildfire (Hungarian: Futótüz) is a 1944 Hungarian historical drama film directed by Zoltán Farkas and starring Ilonka Szabó, László Szilassy and Vera Szemere. It was shot at the Hunnia Studios in Budapest with sets designed by the art director János Pagonyi. It is inspired by the nineteenth century actress Déryné Róza Széppataki and is also known by the alternative title Déryné.


== Cast ==
Ilonka Szabó as 	Déryné
László Szilassy as Bartha Ákos
Vera Szemere as 	Éva
Gyula Csortos as 	Színiigazgató
Piroska Vaszary as 	Lóri – Déryné öltöztetõnõje
Árpád Lehotay as 	Gubernátor
Ilona Tasnádi as 	Gubernátorné
László Földényi as Bartha apja
Zoltán Szakáts as 	Szentpétery
Zoltán Makláry as	Szabó
Jenö Danis as 	Áron – inas
Endre C. Turáni as 	Hórihorgas
Gusztáv Vándory as 	Hajnisch
István Szegedi Szabó as 	Kemény báró
Pál Vessely as 	Rendezõ
Lajos Alszeghy as 	Színész
Ernõ Bartos as Vendég
Rózsi Bordás as 	Pékné
István Falussy as 	Vendég az estélyen
Gusztáv Harasztos as 	Színházi vendég
Sándor Hidassy as 	Rendbontó
Gyözö Kabók as 	Pék
József Medgyessy as 	Súgó


== See also ==
Déryné, a 1951 Hungarian film


== References ==


== Bibliography ==
Juhász, István. Kincses magyar filmtár 1931–1944: az eredeti...